,chrom,start,end,name,gieStain,colors,width
0,1,2300000,5300000,p36.32,gpos25,"(0.6, 0.6, 0.6)",3000000
1,1,5300000,7100000,p36.31,gneg,"(1.0, 1.0, 1.0)",1800000
2,1,7100000,9100000,p36.23,gpos25,"(0.6, 0.6, 0.6)",2000000
3,1,9100000,12500000,p36.22,gneg,"(1.0, 1.0, 1.0)",3400000
4,1,12500000,15900000,p36.21,gpos50,"(0.4, 0.4, 0.4)",3400000
5,1,15900000,20100000,p36.13,gneg,"(1.0, 1.0, 1.0)",4200000
6,1,20100000,23600000,p36.12,gpos25,"(0.6, 0.6, 0.6)",3500000
7,1,23600000,27600000,p36.11,gneg,"(1.0, 1.0, 1.0)",4000000
8,1,27600000,29900000,p35.3,gpos25,"(0.6, 0.6, 0.6)",2300000
9,1,29900000,32300000,p35.2,gneg,"(1.0, 1.0, 1.0)",2400000
10,1,32300000,34300000,p35.1,gpos25,"(0.6, 0.6, 0.6)",2000000
11,1,34300000,39600000,p34.3,gneg,"(1.0, 1.0, 1.0)",5300000
12,1,39600000,43700000,p34.2,gpos25,"(0.6, 0.6, 0.6)",4100000
13,1,43700000,46300000,p34.1,gneg,"(1.0, 1.0, 1.0)",2600000
14,1,46300000,50200000,p33,gpos75,"(0.2, 0.2, 0.2)",3900000
15,1,50200000,55600000,p32.3,gneg,"(1.0, 1.0, 1.0)",5400000
16,1,55600000,58500000,p32.2,gpos50,"(0.4, 0.4, 0.4)",2900000
17,1,58500000,60800000,p32.1,gneg,"(1.0, 1.0, 1.0)",2300000
18,1,60800000,68500000,p31.3,gpos50,"(0.4, 0.4, 0.4)",7700000
19,1,68500000,69300000,p31.2,gneg,"(1.0, 1.0, 1.0)",800000
20,1,69300000,84400000,p31.1,gpos100,"(0.0, 0.0, 0.0)",15100000
21,1,84400000,87900000,p22.3,gneg,"(1.0, 1.0, 1.0)",3500000
22,1,87900000,91500000,p22.2,gpos75,"(0.2, 0.2, 0.2)",3600000
23,1,91500000,94300000,p22.1,gneg,"(1.0, 1.0, 1.0)",2800000
24,1,94300000,99300000,p21.3,gpos75,"(0.2, 0.2, 0.2)",5000000
25,1,99300000,101800000,p21.2,gneg,"(1.0, 1.0, 1.0)",2500000
26,1,101800000,106700000,p21.1,gpos100,"(0.0, 0.0, 0.0)",4900000
27,1,106700000,111200000,p13.3,gneg,"(1.0, 1.0, 1.0)",4500000
28,1,111200000,115500000,p13.2,gpos50,"(0.4, 0.4, 0.4)",4300000
29,1,115500000,117200000,p13.1,gneg,"(1.0, 1.0, 1.0)",1700000
30,1,117200000,120400000,p12,gpos50,"(0.4, 0.4, 0.4)",3200000
31,1,120400000,121700000,p11.2,gneg,"(1.0, 1.0, 1.0)",1300000
32,1,121700000,123400000,p11.1,acen,red,1700000
33,1,123400000,125100000,q11,acen,red,1700000
34,1,125100000,143200000,q12,gvar,"(0.8, 0.8, 0.8)",18100000
35,1,143200000,147500000,q21.1,gneg,"(1.0, 1.0, 1.0)",4300000
36,1,147500000,150600000,q21.2,gpos50,"(0.4, 0.4, 0.4)",3100000
37,1,150600000,155100000,q21.3,gneg,"(1.0, 1.0, 1.0)",4500000
38,1,155100000,156600000,q22,gpos50,"(0.4, 0.4, 0.4)",1500000
39,1,156600000,159100000,q23.1,gneg,"(1.0, 1.0, 1.0)",2500000
40,1,159100000,160500000,q23.2,gpos50,"(0.4, 0.4, 0.4)",1400000
41,1,160500000,165500000,q23.3,gneg,"(1.0, 1.0, 1.0)",5000000
42,1,165500000,167200000,q24.1,gpos50,"(0.4, 0.4, 0.4)",1700000
43,1,167200000,170900000,q24.2,gneg,"(1.0, 1.0, 1.0)",3700000
44,1,170900000,173000000,q24.3,gpos75,"(0.2, 0.2, 0.2)",2100000
45,1,173000000,176100000,q25.1,gneg,"(1.0, 1.0, 1.0)",3100000
46,1,176100000,180300000,q25.2,gpos50,"(0.4, 0.4, 0.4)",4200000
47,1,180300000,185800000,q25.3,gneg,"(1.0, 1.0, 1.0)",5500000
48,1,185800000,190800000,q31.1,gpos100,"(0.0, 0.0, 0.0)",5000000
49,1,190800000,193800000,q31.2,gneg,"(1.0, 1.0, 1.0)",3000000
50,1,193800000,198700000,q31.3,gpos100,"(0.0, 0.0, 0.0)",4900000
51,1,198700000,207100000,q32.1,gneg,"(1.0, 1.0, 1.0)",8400000
52,1,207100000,211300000,q32.2,gpos25,"(0.6, 0.6, 0.6)",4200000
53,1,211300000,214400000,q32.3,gneg,"(1.0, 1.0, 1.0)",3100000
54,1,214400000,223900000,q41,gpos100,"(0.0, 0.0, 0.0)",9500000
55,1,223900000,224400000,q42.11,gneg,"(1.0, 1.0, 1.0)",500000
56,1,224400000,226800000,q42.12,gpos25,"(0.6, 0.6, 0.6)",2400000
57,1,226800000,230500000,q42.13,gneg,"(1.0, 1.0, 1.0)",3700000
58,1,230500000,234600000,q42.2,gpos50,"(0.4, 0.4, 0.4)",4100000
59,1,234600000,236400000,q42.3,gneg,"(1.0, 1.0, 1.0)",1800000
60,1,236400000,243500000,q43,gpos75,"(0.2, 0.2, 0.2)",7100000
61,1,243500000,248956422,q44,gneg,"(1.0, 1.0, 1.0)",5456422
62,10,0,3000000,p15.3,gneg,"(1.0, 1.0, 1.0)",3000000
63,10,3000000,3800000,p15.2,gpos25,"(0.6, 0.6, 0.6)",800000
64,10,3800000,6600000,p15.1,gneg,"(1.0, 1.0, 1.0)",2800000
65,10,6600000,12200000,p14,gpos75,"(0.2, 0.2, 0.2)",5600000
66,10,12200000,17300000,p13,gneg,"(1.0, 1.0, 1.0)",5100000
67,10,17300000,18300000,p12.33,gpos75,"(0.2, 0.2, 0.2)",1000000
68,10,18300000,18400000,p12.32,gneg,"(1.0, 1.0, 1.0)",100000
69,10,18400000,22300000,p12.31,gpos75,"(0.2, 0.2, 0.2)",3900000
70,10,22300000,24300000,p12.2,gneg,"(1.0, 1.0, 1.0)",2000000
71,10,24300000,29300000,p12.1,gpos50,"(0.4, 0.4, 0.4)",5000000
72,10,29300000,31100000,p11.23,gneg,"(1.0, 1.0, 1.0)",1800000
73,10,31100000,34200000,p11.22,gpos25,"(0.6, 0.6, 0.6)",3100000
74,10,34200000,38000000,p11.21,gneg,"(1.0, 1.0, 1.0)",3800000
75,10,38000000,39800000,p11.1,acen,red,1800000
76,10,39800000,41600000,q11.1,acen,red,1800000
77,10,41600000,45500000,q11.21,gneg,"(1.0, 1.0, 1.0)",3900000
78,10,45500000,48600000,q11.22,gpos25,"(0.6, 0.6, 0.6)",3100000
79,10,48600000,51100000,q11.23,gneg,"(1.0, 1.0, 1.0)",2500000
80,10,51100000,59400000,q21.1,gpos100,"(0.0, 0.0, 0.0)",8300000
81,10,59400000,62800000,q21.2,gneg,"(1.0, 1.0, 1.0)",3400000
82,10,62800000,68800000,q21.3,gpos100,"(0.0, 0.0, 0.0)",6000000
83,10,68800000,73100000,q22.1,gneg,"(1.0, 1.0, 1.0)",4300000
84,10,73100000,75900000,q22.2,gpos50,"(0.4, 0.4, 0.4)",2800000
85,10,75900000,80300000,q22.3,gneg,"(1.0, 1.0, 1.0)",4400000
86,10,80300000,86100000,q23.1,gpos100,"(0.0, 0.0, 0.0)",5800000
87,10,86100000,87700000,q23.2,gneg,"(1.0, 1.0, 1.0)",1600000
88,10,87700000,91100000,q23.31,gpos75,"(0.2, 0.2, 0.2)",3400000
89,10,91100000,92300000,q23.32,gneg,"(1.0, 1.0, 1.0)",1200000
90,10,92300000,95300000,q23.33,gpos50,"(0.4, 0.4, 0.4)",3000000
91,10,95300000,97500000,q24.1,gneg,"(1.0, 1.0, 1.0)",2200000
92,10,97500000,100100000,q24.2,gpos50,"(0.4, 0.4, 0.4)",2600000
93,10,100100000,101200000,q24.31,gneg,"(1.0, 1.0, 1.0)",1100000
94,10,101200000,103100000,q24.32,gpos25,"(0.6, 0.6, 0.6)",1900000
95,10,103100000,104000000,q24.33,gneg,"(1.0, 1.0, 1.0)",900000
96,10,104000000,110100000,q25.1,gpos100,"(0.0, 0.0, 0.0)",6100000
97,10,110100000,113100000,q25.2,gneg,"(1.0, 1.0, 1.0)",3000000
98,10,113100000,117300000,q25.3,gpos75,"(0.2, 0.2, 0.2)",4200000
99,10,117300000,119900000,q26.11,gneg,"(1.0, 1.0, 1.0)",2600000
100,10,119900000,121400000,q26.12,gpos50,"(0.4, 0.4, 0.4)",1500000
101,10,121400000,125700000,q26.13,gneg,"(1.0, 1.0, 1.0)",4300000
102,10,125700000,128800000,q26.2,gpos50,"(0.4, 0.4, 0.4)",3100000
103,10,128800000,133797422,q26.3,gneg,"(1.0, 1.0, 1.0)",4997422
108,11,0,2800000,p15.5,gneg,"(1.0, 1.0, 1.0)",2800000
109,11,2800000,11700000,p15.4,gpos50,"(0.4, 0.4, 0.4)",8900000
110,11,11700000,13800000,p15.3,gneg,"(1.0, 1.0, 1.0)",2100000
111,11,13800000,16900000,p15.2,gpos50,"(0.4, 0.4, 0.4)",3100000
112,11,16900000,22000000,p15.1,gneg,"(1.0, 1.0, 1.0)",5100000
113,11,22000000,26200000,p14.3,gpos100,"(0.0, 0.0, 0.0)",4200000
114,11,26200000,27200000,p14.2,gneg,"(1.0, 1.0, 1.0)",1000000
115,11,27200000,31000000,p14.1,gpos75,"(0.2, 0.2, 0.2)",3800000
116,11,31000000,36400000,p13,gneg,"(1.0, 1.0, 1.0)",5400000
117,11,36400000,43400000,p12,gpos100,"(0.0, 0.0, 0.0)",7000000
118,11,43400000,48800000,p11.2,gneg,"(1.0, 1.0, 1.0)",5400000
119,11,48800000,51000000,p11.12,gpos75,"(0.2, 0.2, 0.2)",2200000
120,11,51000000,53400000,p11.11,acen,red,2400000
121,11,53400000,55800000,q11,acen,red,2400000
122,11,55800000,60100000,q12.1,gpos75,"(0.2, 0.2, 0.2)",4300000
123,11,60100000,61900000,q12.2,gneg,"(1.0, 1.0, 1.0)",1800000
124,11,61900000,63600000,q12.3,gpos25,"(0.6, 0.6, 0.6)",1700000
125,11,63600000,66100000,q13.1,gneg,"(1.0, 1.0, 1.0)",2500000
126,11,66100000,68700000,q13.2,gpos25,"(0.6, 0.6, 0.6)",2600000
127,11,68700000,70500000,q13.3,gneg,"(1.0, 1.0, 1.0)",1800000
128,11,70500000,75500000,q13.4,gpos50,"(0.4, 0.4, 0.4)",5000000
129,11,75500000,77400000,q13.5,gneg,"(1.0, 1.0, 1.0)",1900000
130,11,77400000,85900000,q14.1,gpos100,"(0.0, 0.0, 0.0)",8500000
131,11,85900000,88600000,q14.2,gneg,"(1.0, 1.0, 1.0)",2700000
132,11,88600000,93000000,q14.3,gpos100,"(0.0, 0.0, 0.0)",4400000
133,11,93000000,97400000,q21,gneg,"(1.0, 1.0, 1.0)",4400000
134,11,97400000,102300000,q22.1,gpos100,"(0.0, 0.0, 0.0)",4900000
135,11,102300000,103000000,q22.2,gneg,"(1.0, 1.0, 1.0)",700000
136,11,103000000,110600000,q22.3,gpos100,"(0.0, 0.0, 0.0)",7600000
137,11,110600000,112700000,q23.1,gneg,"(1.0, 1.0, 1.0)",2100000
138,11,112700000,114600000,q23.2,gpos50,"(0.4, 0.4, 0.4)",1900000
139,11,114600000,121300000,q23.3,gneg,"(1.0, 1.0, 1.0)",6700000
140,11,121300000,124000000,q24.1,gpos50,"(0.4, 0.4, 0.4)",2700000
141,11,124000000,127900000,q24.2,gneg,"(1.0, 1.0, 1.0)",3900000
142,11,127900000,130900000,q24.3,gpos50,"(0.4, 0.4, 0.4)",3000000
143,11,130900000,135086622,q25,gneg,"(1.0, 1.0, 1.0)",4186622
157,12,0,3200000,p13.33,gneg,"(1.0, 1.0, 1.0)",3200000
158,12,3200000,5300000,p13.32,gpos25,"(0.6, 0.6, 0.6)",2100000
159,12,5300000,10000000,p13.31,gneg,"(1.0, 1.0, 1.0)",4700000
160,12,10000000,12600000,p13.2,gpos75,"(0.2, 0.2, 0.2)",2600000
161,12,12600000,14600000,p13.1,gneg,"(1.0, 1.0, 1.0)",2000000
162,12,14600000,19800000,p12.3,gpos100,"(0.0, 0.0, 0.0)",5200000
163,12,19800000,21100000,p12.2,gneg,"(1.0, 1.0, 1.0)",1300000
164,12,21100000,26300000,p12.1,gpos100,"(0.0, 0.0, 0.0)",5200000
165,12,26300000,27600000,p11.23,gneg,"(1.0, 1.0, 1.0)",1300000
166,12,27600000,30500000,p11.22,gpos50,"(0.4, 0.4, 0.4)",2900000
167,12,30500000,33200000,p11.21,gneg,"(1.0, 1.0, 1.0)",2700000
168,12,33200000,35500000,p11.1,acen,red,2300000
169,12,35500000,37800000,q11,acen,red,2300000
170,12,37800000,46000000,q12,gpos100,"(0.0, 0.0, 0.0)",8200000
171,12,46000000,48700000,q13.11,gneg,"(1.0, 1.0, 1.0)",2700000
172,12,48700000,51100000,q13.12,gpos25,"(0.6, 0.6, 0.6)",2400000
173,12,51100000,54500000,q13.13,gneg,"(1.0, 1.0, 1.0)",3400000
174,12,54500000,56200000,q13.2,gpos25,"(0.6, 0.6, 0.6)",1700000
175,12,56200000,57700000,q13.3,gneg,"(1.0, 1.0, 1.0)",1500000
176,12,57700000,62700000,q14.1,gpos75,"(0.2, 0.2, 0.2)",5000000
177,12,62700000,64700000,q14.2,gneg,"(1.0, 1.0, 1.0)",2000000
178,12,64700000,67300000,q14.3,gpos50,"(0.4, 0.4, 0.4)",2600000
179,12,67300000,71100000,q15,gneg,"(1.0, 1.0, 1.0)",3800000
180,12,71100000,75300000,q21.1,gpos75,"(0.2, 0.2, 0.2)",4200000
181,12,75300000,79900000,q21.2,gneg,"(1.0, 1.0, 1.0)",4600000
182,12,79900000,86300000,q21.31,gpos100,"(0.0, 0.0, 0.0)",6400000
183,12,86300000,88600000,q21.32,gneg,"(1.0, 1.0, 1.0)",2300000
184,12,88600000,92200000,q21.33,gpos100,"(0.0, 0.0, 0.0)",3600000
185,12,92200000,95800000,q22,gneg,"(1.0, 1.0, 1.0)",3600000
186,12,95800000,101200000,q23.1,gpos75,"(0.2, 0.2, 0.2)",5400000
187,12,101200000,103500000,q23.2,gneg,"(1.0, 1.0, 1.0)",2300000
188,12,103500000,108600000,q23.3,gpos50,"(0.4, 0.4, 0.4)",5100000
189,12,108600000,111300000,q24.11,gneg,"(1.0, 1.0, 1.0)",2700000
190,12,111300000,111900000,q24.12,gpos25,"(0.6, 0.6, 0.6)",600000
191,12,111900000,113900000,q24.13,gneg,"(1.0, 1.0, 1.0)",2000000
192,12,113900000,116400000,q24.21,gpos50,"(0.4, 0.4, 0.4)",2500000
193,12,116400000,117700000,q24.22,gneg,"(1.0, 1.0, 1.0)",1300000
194,12,117700000,120300000,q24.23,gpos50,"(0.4, 0.4, 0.4)",2600000
195,12,120300000,125400000,q24.31,gneg,"(1.0, 1.0, 1.0)",5100000
196,12,125400000,128700000,q24.32,gpos50,"(0.4, 0.4, 0.4)",3300000
197,12,128700000,133275309,q24.33,gneg,"(1.0, 1.0, 1.0)",4575309
211,13,0,4600000,p13,gvar,"(0.8, 0.8, 0.8)",4600000
212,13,4600000,10100000,p12,stalk,"(0.9, 0.9, 0.9)",5500000
213,13,10100000,16500000,p11.2,gvar,"(0.8, 0.8, 0.8)",6400000
214,13,16500000,17700000,p11.1,acen,red,1200000
215,13,17700000,18900000,q11,acen,red,1200000
216,13,18900000,22600000,q12.11,gneg,"(1.0, 1.0, 1.0)",3700000
217,13,22600000,24900000,q12.12,gpos25,"(0.6, 0.6, 0.6)",2300000
218,13,24900000,27200000,q12.13,gneg,"(1.0, 1.0, 1.0)",2300000
219,13,27200000,28300000,q12.2,gpos25,"(0.6, 0.6, 0.6)",1100000
220,13,28300000,31600000,q12.3,gneg,"(1.0, 1.0, 1.0)",3300000
221,13,31600000,33400000,q13.1,gpos50,"(0.4, 0.4, 0.4)",1800000
222,13,33400000,34900000,q13.2,gneg,"(1.0, 1.0, 1.0)",1500000
223,13,34900000,39500000,q13.3,gpos75,"(0.2, 0.2, 0.2)",4600000
224,13,39500000,44600000,q14.11,gneg,"(1.0, 1.0, 1.0)",5100000
225,13,44600000,45200000,q14.12,gpos25,"(0.6, 0.6, 0.6)",600000
226,13,45200000,46700000,q14.13,gneg,"(1.0, 1.0, 1.0)",1500000
227,13,46700000,50300000,q14.2,gpos50,"(0.4, 0.4, 0.4)",3600000
228,13,50300000,54700000,q14.3,gneg,"(1.0, 1.0, 1.0)",4400000
229,13,54700000,59000000,q21.1,gpos100,"(0.0, 0.0, 0.0)",4300000
230,13,59000000,61800000,q21.2,gneg,"(1.0, 1.0, 1.0)",2800000
231,13,61800000,65200000,q21.31,gpos75,"(0.2, 0.2, 0.2)",3400000
232,13,65200000,68100000,q21.32,gneg,"(1.0, 1.0, 1.0)",2900000
233,13,68100000,72800000,q21.33,gpos100,"(0.0, 0.0, 0.0)",4700000
234,13,72800000,74900000,q22.1,gneg,"(1.0, 1.0, 1.0)",2100000
235,13,74900000,76700000,q22.2,gpos50,"(0.4, 0.4, 0.4)",1800000
236,13,76700000,78500000,q22.3,gneg,"(1.0, 1.0, 1.0)",1800000
237,13,78500000,87100000,q31.1,gpos100,"(0.0, 0.0, 0.0)",8600000
238,13,87100000,89400000,q31.2,gneg,"(1.0, 1.0, 1.0)",2300000
239,13,89400000,94400000,q31.3,gpos100,"(0.0, 0.0, 0.0)",5000000
240,13,94400000,97500000,q32.1,gneg,"(1.0, 1.0, 1.0)",3100000
241,13,97500000,98700000,q32.2,gpos25,"(0.6, 0.6, 0.6)",1200000
242,13,98700000,101100000,q32.3,gneg,"(1.0, 1.0, 1.0)",2400000
243,13,101100000,104200000,q33.1,gpos100,"(0.0, 0.0, 0.0)",3100000
244,13,104200000,106400000,q33.2,gneg,"(1.0, 1.0, 1.0)",2200000
245,13,106400000,109600000,q33.3,gpos100,"(0.0, 0.0, 0.0)",3200000
246,13,109600000,114364328,q34,gneg,"(1.0, 1.0, 1.0)",4764328
253,14,0,3600000,p13,gvar,"(0.8, 0.8, 0.8)",3600000
254,14,3600000,8000000,p12,stalk,"(0.9, 0.9, 0.9)",4400000
255,14,8000000,16100000,p11.2,gvar,"(0.8, 0.8, 0.8)",8100000
256,14,16100000,17200000,p11.1,acen,red,1100000
257,14,17200000,18200000,q11.1,acen,red,1000000
258,14,18200000,24100000,q11.2,gneg,"(1.0, 1.0, 1.0)",5900000
259,14,24100000,32900000,q12,gpos100,"(0.0, 0.0, 0.0)",8800000
260,14,32900000,34800000,q13.1,gneg,"(1.0, 1.0, 1.0)",1900000
261,14,34800000,36100000,q13.2,gpos50,"(0.4, 0.4, 0.4)",1300000
262,14,36100000,37400000,q13.3,gneg,"(1.0, 1.0, 1.0)",1300000
263,14,37400000,43000000,q21.1,gpos100,"(0.0, 0.0, 0.0)",5600000
264,14,43000000,46700000,q21.2,gneg,"(1.0, 1.0, 1.0)",3700000
265,14,46700000,50400000,q21.3,gpos100,"(0.0, 0.0, 0.0)",3700000
266,14,50400000,53600000,q22.1,gneg,"(1.0, 1.0, 1.0)",3200000
267,14,53600000,55000000,q22.2,gpos25,"(0.6, 0.6, 0.6)",1400000
268,14,55000000,57600000,q22.3,gneg,"(1.0, 1.0, 1.0)",2600000
269,14,57600000,61600000,q23.1,gpos75,"(0.2, 0.2, 0.2)",4000000
270,14,61600000,64300000,q23.2,gneg,"(1.0, 1.0, 1.0)",2700000
271,14,64300000,67400000,q23.3,gpos50,"(0.4, 0.4, 0.4)",3100000
272,14,67400000,69800000,q24.1,gneg,"(1.0, 1.0, 1.0)",2400000
273,14,69800000,73300000,q24.2,gpos50,"(0.4, 0.4, 0.4)",3500000
274,14,73300000,78800000,q24.3,gneg,"(1.0, 1.0, 1.0)",5500000
275,14,78800000,83100000,q31.1,gpos100,"(0.0, 0.0, 0.0)",4300000
276,14,83100000,84400000,q31.2,gneg,"(1.0, 1.0, 1.0)",1300000
277,14,84400000,89300000,q31.3,gpos100,"(0.0, 0.0, 0.0)",4900000
278,14,89300000,91400000,q32.11,gneg,"(1.0, 1.0, 1.0)",2100000
279,14,91400000,94200000,q32.12,gpos25,"(0.6, 0.6, 0.6)",2800000
280,14,94200000,95800000,q32.13,gneg,"(1.0, 1.0, 1.0)",1600000
281,14,95800000,100900000,q32.2,gpos50,"(0.4, 0.4, 0.4)",5100000
282,14,100900000,102700000,q32.31,gneg,"(1.0, 1.0, 1.0)",1800000
283,14,102700000,103500000,q32.32,gpos50,"(0.4, 0.4, 0.4)",800000
284,14,103500000,107043718,q32.33,gneg,"(1.0, 1.0, 1.0)",3543718
297,15,0,4200000,p13,gvar,"(0.8, 0.8, 0.8)",4200000
298,15,4200000,9700000,p12,stalk,"(0.9, 0.9, 0.9)",5500000
299,15,9700000,17500000,p11.2,gvar,"(0.8, 0.8, 0.8)",7800000
300,15,17500000,19000000,p11.1,acen,red,1500000
301,15,19000000,20500000,q11.1,acen,red,1500000
302,15,20500000,25500000,q11.2,gneg,"(1.0, 1.0, 1.0)",5000000
303,15,25500000,27800000,q12,gpos50,"(0.4, 0.4, 0.4)",2300000
304,15,27800000,30000000,q13.1,gneg,"(1.0, 1.0, 1.0)",2200000
305,15,30000000,30900000,q13.2,gpos50,"(0.4, 0.4, 0.4)",900000
306,15,30900000,33400000,q13.3,gneg,"(1.0, 1.0, 1.0)",2500000
307,15,33400000,39800000,q14,gpos75,"(0.2, 0.2, 0.2)",6400000
308,15,39800000,42500000,q15.1,gneg,"(1.0, 1.0, 1.0)",2700000
309,15,42500000,43300000,q15.2,gpos25,"(0.6, 0.6, 0.6)",800000
310,15,43300000,44500000,q15.3,gneg,"(1.0, 1.0, 1.0)",1200000
311,15,44500000,49200000,q21.1,gpos75,"(0.2, 0.2, 0.2)",4700000
312,15,49200000,52600000,q21.2,gneg,"(1.0, 1.0, 1.0)",3400000
313,15,52600000,58800000,q21.3,gpos75,"(0.2, 0.2, 0.2)",6200000
314,15,58800000,59000000,q22.1,gneg,"(1.0, 1.0, 1.0)",200000
315,15,59000000,63400000,q22.2,gpos25,"(0.6, 0.6, 0.6)",4400000
316,15,63400000,66900000,q22.31,gneg,"(1.0, 1.0, 1.0)",3500000
317,15,66900000,67000000,q22.32,gpos25,"(0.6, 0.6, 0.6)",100000
318,15,67000000,67200000,q22.33,gneg,"(1.0, 1.0, 1.0)",200000
319,15,67200000,72400000,q23,gpos25,"(0.6, 0.6, 0.6)",5200000
320,15,72400000,74900000,q24.1,gneg,"(1.0, 1.0, 1.0)",2500000
321,15,74900000,76300000,q24.2,gpos25,"(0.6, 0.6, 0.6)",1400000
322,15,76300000,78000000,q24.3,gneg,"(1.0, 1.0, 1.0)",1700000
323,15,78000000,81400000,q25.1,gpos50,"(0.4, 0.4, 0.4)",3400000
324,15,81400000,84700000,q25.2,gneg,"(1.0, 1.0, 1.0)",3300000
325,15,84700000,88500000,q25.3,gpos50,"(0.4, 0.4, 0.4)",3800000
326,15,88500000,93800000,q26.1,gneg,"(1.0, 1.0, 1.0)",5300000
327,15,93800000,98000000,q26.2,gpos50,"(0.4, 0.4, 0.4)",4200000
328,15,98000000,101991189,q26.3,gneg,"(1.0, 1.0, 1.0)",3991189
339,16,0,7800000,p13.3,gneg,"(1.0, 1.0, 1.0)",7800000
340,16,7800000,10400000,p13.2,gpos50,"(0.4, 0.4, 0.4)",2600000
341,16,10400000,12500000,p13.13,gneg,"(1.0, 1.0, 1.0)",2100000
342,16,12500000,14700000,p13.12,gpos50,"(0.4, 0.4, 0.4)",2200000
343,16,14700000,16700000,p13.11,gneg,"(1.0, 1.0, 1.0)",2000000
344,16,16700000,21200000,p12.3,gpos50,"(0.4, 0.4, 0.4)",4500000
345,16,21200000,24200000,p12.2,gneg,"(1.0, 1.0, 1.0)",3000000
346,16,24200000,28500000,p12.1,gpos50,"(0.4, 0.4, 0.4)",4300000
347,16,28500000,35300000,p11.2,gneg,"(1.0, 1.0, 1.0)",6800000
348,16,35300000,36800000,p11.1,acen,red,1500000
349,16,36800000,38400000,q11.1,acen,red,1600000
350,16,38400000,47000000,q11.2,gvar,"(0.8, 0.8, 0.8)",8600000
351,16,47000000,52600000,q12.1,gneg,"(1.0, 1.0, 1.0)",5600000
352,16,52600000,56000000,q12.2,gpos50,"(0.4, 0.4, 0.4)",3400000
353,16,56000000,57300000,q13,gneg,"(1.0, 1.0, 1.0)",1300000
354,16,57300000,66600000,q21,gpos100,"(0.0, 0.0, 0.0)",9300000
355,16,66600000,70800000,q22.1,gneg,"(1.0, 1.0, 1.0)",4200000
356,16,70800000,72800000,q22.2,gpos50,"(0.4, 0.4, 0.4)",2000000
357,16,72800000,74100000,q22.3,gneg,"(1.0, 1.0, 1.0)",1300000
358,16,74100000,79200000,q23.1,gpos75,"(0.2, 0.2, 0.2)",5100000
359,16,79200000,81600000,q23.2,gneg,"(1.0, 1.0, 1.0)",2400000
360,16,81600000,84100000,q23.3,gpos50,"(0.4, 0.4, 0.4)",2500000
361,16,84100000,87000000,q24.1,gneg,"(1.0, 1.0, 1.0)",2900000
362,16,87000000,88700000,q24.2,gpos25,"(0.6, 0.6, 0.6)",1700000
363,16,88700000,90338345,q24.3,gneg,"(1.0, 1.0, 1.0)",1638345
371,17,0,3400000,p13.3,gneg,"(1.0, 1.0, 1.0)",3400000
372,17,3400000,6500000,p13.2,gpos50,"(0.4, 0.4, 0.4)",3100000
373,17,6500000,10800000,p13.1,gneg,"(1.0, 1.0, 1.0)",4300000
374,17,10800000,16100000,p12,gpos75,"(0.2, 0.2, 0.2)",5300000
375,17,16100000,22700000,p11.2,gneg,"(1.0, 1.0, 1.0)",6600000
376,17,22700000,25100000,p11.1,acen,red,2400000
377,17,25100000,27400000,q11.1,acen,red,2300000
378,17,27400000,33500000,q11.2,gneg,"(1.0, 1.0, 1.0)",6100000
379,17,33500000,39800000,q12,gpos50,"(0.4, 0.4, 0.4)",6300000
380,17,39800000,40200000,q21.1,gneg,"(1.0, 1.0, 1.0)",400000
381,17,40200000,42800000,q21.2,gpos25,"(0.6, 0.6, 0.6)",2600000
382,17,42800000,46800000,q21.31,gneg,"(1.0, 1.0, 1.0)",4000000
383,17,46800000,49300000,q21.32,gpos25,"(0.6, 0.6, 0.6)",2500000
384,17,49300000,52100000,q21.33,gneg,"(1.0, 1.0, 1.0)",2800000
385,17,52100000,59500000,q22,gpos75,"(0.2, 0.2, 0.2)",7400000
386,17,59500000,60200000,q23.1,gneg,"(1.0, 1.0, 1.0)",700000
387,17,60200000,63100000,q23.2,gpos75,"(0.2, 0.2, 0.2)",2900000
388,17,63100000,64600000,q23.3,gneg,"(1.0, 1.0, 1.0)",1500000
389,17,64600000,66200000,q24.1,gpos50,"(0.4, 0.4, 0.4)",1600000
390,17,66200000,69100000,q24.2,gneg,"(1.0, 1.0, 1.0)",2900000
391,17,69100000,72900000,q24.3,gpos75,"(0.2, 0.2, 0.2)",3800000
392,17,72900000,76800000,q25.1,gneg,"(1.0, 1.0, 1.0)",3900000
393,17,76800000,77200000,q25.2,gpos25,"(0.6, 0.6, 0.6)",400000
394,17,77200000,83257441,q25.3,gneg,"(1.0, 1.0, 1.0)",6057441
416,18,0,2900000,p11.32,gneg,"(1.0, 1.0, 1.0)",2900000
417,18,2900000,7200000,p11.31,gpos50,"(0.4, 0.4, 0.4)",4300000
418,18,7200000,8500000,p11.23,gneg,"(1.0, 1.0, 1.0)",1300000
419,18,8500000,10900000,p11.22,gpos25,"(0.6, 0.6, 0.6)",2400000
420,18,10900000,15400000,p11.21,gneg,"(1.0, 1.0, 1.0)",4500000
421,18,15400000,18500000,p11.1,acen,red,3100000
422,18,18500000,21500000,q11.1,acen,red,3000000
423,18,21500000,27500000,q11.2,gneg,"(1.0, 1.0, 1.0)",6000000
424,18,27500000,35100000,q12.1,gpos100,"(0.0, 0.0, 0.0)",7600000
425,18,35100000,39500000,q12.2,gneg,"(1.0, 1.0, 1.0)",4400000
426,18,39500000,45900000,q12.3,gpos75,"(0.2, 0.2, 0.2)",6400000
427,18,45900000,50700000,q21.1,gneg,"(1.0, 1.0, 1.0)",4800000
428,18,50700000,56200000,q21.2,gpos75,"(0.2, 0.2, 0.2)",5500000
429,18,56200000,58600000,q21.31,gneg,"(1.0, 1.0, 1.0)",2400000
430,18,58600000,61300000,q21.32,gpos50,"(0.4, 0.4, 0.4)",2700000
431,18,61300000,63900000,q21.33,gneg,"(1.0, 1.0, 1.0)",2600000
432,18,63900000,69100000,q22.1,gpos100,"(0.0, 0.0, 0.0)",5200000
433,18,69100000,71000000,q22.2,gneg,"(1.0, 1.0, 1.0)",1900000
434,18,71000000,75400000,q22.3,gpos25,"(0.6, 0.6, 0.6)",4400000
435,18,75400000,80373285,q23,gneg,"(1.0, 1.0, 1.0)",4973285
446,19,0,6900000,p13.3,gneg,"(1.0, 1.0, 1.0)",6900000
447,19,6900000,12600000,p13.2,gpos25,"(0.6, 0.6, 0.6)",5700000
448,19,12600000,13800000,p13.13,gneg,"(1.0, 1.0, 1.0)",1200000
449,19,13800000,16100000,p13.12,gpos25,"(0.6, 0.6, 0.6)",2300000
450,19,16100000,19900000,p13.11,gneg,"(1.0, 1.0, 1.0)",3800000
451,19,19900000,24200000,p12,gvar,"(0.8, 0.8, 0.8)",4300000
452,19,24200000,26200000,p11,acen,red,2000000
453,19,26200000,28100000,q11,acen,red,1900000
454,19,28100000,31900000,q12,gvar,"(0.8, 0.8, 0.8)",3800000
455,19,31900000,35100000,q13.11,gneg,"(1.0, 1.0, 1.0)",3200000
456,19,35100000,37800000,q13.12,gpos25,"(0.6, 0.6, 0.6)",2700000
457,19,37800000,38200000,q13.13,gneg,"(1.0, 1.0, 1.0)",400000
458,19,38200000,42900000,q13.2,gpos25,"(0.6, 0.6, 0.6)",4700000
459,19,42900000,44700000,q13.31,gneg,"(1.0, 1.0, 1.0)",1800000
460,19,44700000,47500000,q13.32,gpos25,"(0.6, 0.6, 0.6)",2800000
461,19,47500000,50900000,q13.33,gneg,"(1.0, 1.0, 1.0)",3400000
462,19,50900000,53100000,q13.41,gpos25,"(0.6, 0.6, 0.6)",2200000
463,19,53100000,55800000,q13.42,gneg,"(1.0, 1.0, 1.0)",2700000
464,19,55800000,58617616,q13.43,gpos25,"(0.6, 0.6, 0.6)",2817616
529,2,0,4400000,p25.3,gneg,"(1.0, 1.0, 1.0)",4400000
530,2,4400000,6900000,p25.2,gpos50,"(0.4, 0.4, 0.4)",2500000
531,2,6900000,12000000,p25.1,gneg,"(1.0, 1.0, 1.0)",5100000
532,2,12000000,16500000,p24.3,gpos75,"(0.2, 0.2, 0.2)",4500000
533,2,16500000,19000000,p24.2,gneg,"(1.0, 1.0, 1.0)",2500000
534,2,19000000,23800000,p24.1,gpos75,"(0.2, 0.2, 0.2)",4800000
535,2,23800000,27700000,p23.3,gneg,"(1.0, 1.0, 1.0)",3900000
536,2,27700000,29800000,p23.2,gpos25,"(0.6, 0.6, 0.6)",2100000
537,2,29800000,31800000,p23.1,gneg,"(1.0, 1.0, 1.0)",2000000
538,2,31800000,36300000,p22.3,gpos75,"(0.2, 0.2, 0.2)",4500000
539,2,36300000,38300000,p22.2,gneg,"(1.0, 1.0, 1.0)",2000000
540,2,38300000,41500000,p22.1,gpos50,"(0.4, 0.4, 0.4)",3200000
541,2,41500000,47500000,p21,gneg,"(1.0, 1.0, 1.0)",6000000
542,2,47500000,52600000,p16.3,gpos100,"(0.0, 0.0, 0.0)",5100000
543,2,52600000,54700000,p16.2,gneg,"(1.0, 1.0, 1.0)",2100000
544,2,54700000,61000000,p16.1,gpos100,"(0.0, 0.0, 0.0)",6300000
545,2,61000000,63900000,p15,gneg,"(1.0, 1.0, 1.0)",2900000
546,2,63900000,68400000,p14,gpos50,"(0.4, 0.4, 0.4)",4500000
547,2,68400000,71300000,p13.3,gneg,"(1.0, 1.0, 1.0)",2900000
548,2,71300000,73300000,p13.2,gpos50,"(0.4, 0.4, 0.4)",2000000
549,2,73300000,74800000,p13.1,gneg,"(1.0, 1.0, 1.0)",1500000
550,2,74800000,83100000,p12,gpos100,"(0.0, 0.0, 0.0)",8300000
551,2,83100000,91800000,p11.2,gneg,"(1.0, 1.0, 1.0)",8700000
552,2,91800000,93900000,p11.1,acen,red,2100000
553,2,93900000,96000000,q11.1,acen,red,2100000
554,2,96000000,102100000,q11.2,gneg,"(1.0, 1.0, 1.0)",6100000
555,2,102100000,105300000,q12.1,gpos50,"(0.4, 0.4, 0.4)",3200000
556,2,105300000,106700000,q12.2,gneg,"(1.0, 1.0, 1.0)",1400000
557,2,106700000,108700000,q12.3,gpos25,"(0.6, 0.6, 0.6)",2000000
558,2,108700000,112200000,q13,gneg,"(1.0, 1.0, 1.0)",3500000
559,2,112200000,118100000,q14.1,gpos50,"(0.4, 0.4, 0.4)",5900000
560,2,118100000,121600000,q14.2,gneg,"(1.0, 1.0, 1.0)",3500000
561,2,121600000,129100000,q14.3,gpos50,"(0.4, 0.4, 0.4)",7500000
562,2,129100000,131700000,q21.1,gneg,"(1.0, 1.0, 1.0)",2600000
563,2,131700000,134300000,q21.2,gpos25,"(0.6, 0.6, 0.6)",2600000
564,2,134300000,136100000,q21.3,gneg,"(1.0, 1.0, 1.0)",1800000
565,2,136100000,141500000,q22.1,gpos100,"(0.0, 0.0, 0.0)",5400000
566,2,141500000,143400000,q22.2,gneg,"(1.0, 1.0, 1.0)",1900000
567,2,143400000,147900000,q22.3,gpos100,"(0.0, 0.0, 0.0)",4500000
568,2,147900000,149000000,q23.1,gneg,"(1.0, 1.0, 1.0)",1100000
569,2,149000000,149600000,q23.2,gpos25,"(0.6, 0.6, 0.6)",600000
570,2,149600000,154000000,q23.3,gneg,"(1.0, 1.0, 1.0)",4400000
571,2,154000000,158900000,q24.1,gpos75,"(0.2, 0.2, 0.2)",4900000
572,2,158900000,162900000,q24.2,gneg,"(1.0, 1.0, 1.0)",4000000
573,2,162900000,168900000,q24.3,gpos75,"(0.2, 0.2, 0.2)",6000000
574,2,168900000,177100000,q31.1,gneg,"(1.0, 1.0, 1.0)",8200000
575,2,177100000,179700000,q31.2,gpos50,"(0.4, 0.4, 0.4)",2600000
576,2,179700000,182100000,q31.3,gneg,"(1.0, 1.0, 1.0)",2400000
577,2,182100000,188500000,q32.1,gpos75,"(0.2, 0.2, 0.2)",6400000
578,2,188500000,191100000,q32.2,gneg,"(1.0, 1.0, 1.0)",2600000
579,2,191100000,196600000,q32.3,gpos75,"(0.2, 0.2, 0.2)",5500000
580,2,196600000,202500000,q33.1,gneg,"(1.0, 1.0, 1.0)",5900000
581,2,202500000,204100000,q33.2,gpos50,"(0.4, 0.4, 0.4)",1600000
582,2,204100000,208200000,q33.3,gneg,"(1.0, 1.0, 1.0)",4100000
583,2,208200000,214500000,q34,gpos100,"(0.0, 0.0, 0.0)",6300000
584,2,214500000,220700000,q35,gneg,"(1.0, 1.0, 1.0)",6200000
585,2,220700000,224300000,q36.1,gpos75,"(0.2, 0.2, 0.2)",3600000
586,2,224300000,225200000,q36.2,gneg,"(1.0, 1.0, 1.0)",900000
587,2,225200000,230100000,q36.3,gpos100,"(0.0, 0.0, 0.0)",4900000
588,2,230100000,234700000,q37.1,gneg,"(1.0, 1.0, 1.0)",4600000
589,2,234700000,236400000,q37.2,gpos50,"(0.4, 0.4, 0.4)",1700000
590,2,236400000,242193529,q37.3,gneg,"(1.0, 1.0, 1.0)",5793529
591,20,0,5100000,p13,gneg,"(1.0, 1.0, 1.0)",5100000
592,20,5100000,9200000,p12.3,gpos75,"(0.2, 0.2, 0.2)",4100000
593,20,9200000,12000000,p12.2,gneg,"(1.0, 1.0, 1.0)",2800000
594,20,12000000,17900000,p12.1,gpos75,"(0.2, 0.2, 0.2)",5900000
595,20,17900000,21300000,p11.23,gneg,"(1.0, 1.0, 1.0)",3400000
596,20,21300000,22300000,p11.22,gpos25,"(0.6, 0.6, 0.6)",1000000
597,20,22300000,25700000,p11.21,gneg,"(1.0, 1.0, 1.0)",3400000
598,20,25700000,28100000,p11.1,acen,red,2400000
599,20,28100000,30400000,q11.1,acen,red,2300000
600,20,30400000,33500000,q11.21,gneg,"(1.0, 1.0, 1.0)",3100000
601,20,33500000,35800000,q11.22,gpos25,"(0.6, 0.6, 0.6)",2300000
602,20,35800000,39000000,q11.23,gneg,"(1.0, 1.0, 1.0)",3200000
603,20,39000000,43100000,q12,gpos75,"(0.2, 0.2, 0.2)",4100000
604,20,43100000,43500000,q13.11,gneg,"(1.0, 1.0, 1.0)",400000
605,20,43500000,47800000,q13.12,gpos25,"(0.6, 0.6, 0.6)",4300000
606,20,47800000,51200000,q13.13,gneg,"(1.0, 1.0, 1.0)",3400000
607,20,51200000,56400000,q13.2,gpos75,"(0.2, 0.2, 0.2)",5200000
608,20,56400000,57800000,q13.31,gneg,"(1.0, 1.0, 1.0)",1400000
609,20,57800000,59700000,q13.32,gpos50,"(0.4, 0.4, 0.4)",1900000
610,20,59700000,64444167,q13.33,gneg,"(1.0, 1.0, 1.0)",4744167
615,21,0,3100000,p13,gvar,"(0.8, 0.8, 0.8)",3100000
616,21,3100000,7000000,p12,stalk,"(0.9, 0.9, 0.9)",3900000
617,21,7000000,10900000,p11.2,gvar,"(0.8, 0.8, 0.8)",3900000
618,21,10900000,12000000,p11.1,acen,red,1100000
619,21,12000000,13000000,q11.1,acen,red,1000000
620,21,13000000,15000000,q11.2,gneg,"(1.0, 1.0, 1.0)",2000000
621,21,15000000,22600000,q21.1,gpos100,"(0.0, 0.0, 0.0)",7600000
622,21,22600000,25500000,q21.2,gneg,"(1.0, 1.0, 1.0)",2900000
623,21,25500000,30200000,q21.3,gpos75,"(0.2, 0.2, 0.2)",4700000
624,21,30200000,34400000,q22.11,gneg,"(1.0, 1.0, 1.0)",4200000
625,21,34400000,36400000,q22.12,gpos50,"(0.4, 0.4, 0.4)",2000000
626,21,36400000,38300000,q22.13,gneg,"(1.0, 1.0, 1.0)",1900000
627,21,38300000,41200000,q22.2,gpos50,"(0.4, 0.4, 0.4)",2900000
628,21,41200000,46709983,q22.3,gneg,"(1.0, 1.0, 1.0)",5509983
636,22,0,4300000,p13,gvar,"(0.8, 0.8, 0.8)",4300000
637,22,4300000,9400000,p12,stalk,"(0.9, 0.9, 0.9)",5100000
638,22,9400000,13700000,p11.2,gvar,"(0.8, 0.8, 0.8)",4300000
639,22,13700000,15000000,p11.1,acen,red,1300000
640,22,15000000,17400000,q11.1,acen,red,2400000
641,22,17400000,21700000,q11.21,gneg,"(1.0, 1.0, 1.0)",4300000
642,22,21700000,23100000,q11.22,gpos25,"(0.6, 0.6, 0.6)",1400000
643,22,23100000,25500000,q11.23,gneg,"(1.0, 1.0, 1.0)",2400000
644,22,25500000,29200000,q12.1,gpos50,"(0.4, 0.4, 0.4)",3700000
645,22,29200000,31800000,q12.2,gneg,"(1.0, 1.0, 1.0)",2600000
646,22,31800000,37200000,q12.3,gpos50,"(0.4, 0.4, 0.4)",5400000
647,22,37200000,40600000,q13.1,gneg,"(1.0, 1.0, 1.0)",3400000
648,22,40600000,43800000,q13.2,gpos50,"(0.4, 0.4, 0.4)",3200000
649,22,43800000,48100000,q13.31,gneg,"(1.0, 1.0, 1.0)",4300000
650,22,48100000,49100000,q13.32,gpos50,"(0.4, 0.4, 0.4)",1000000
651,22,49100000,50818468,q13.33,gneg,"(1.0, 1.0, 1.0)",1718468
687,3,0,2800000,p26.3,gpos50,"(0.4, 0.4, 0.4)",2800000
688,3,2800000,4000000,p26.2,gneg,"(1.0, 1.0, 1.0)",1200000
689,3,4000000,8100000,p26.1,gpos50,"(0.4, 0.4, 0.4)",4100000
690,3,8100000,11600000,p25.3,gneg,"(1.0, 1.0, 1.0)",3500000
691,3,11600000,13200000,p25.2,gpos25,"(0.6, 0.6, 0.6)",1600000
692,3,13200000,16300000,p25.1,gneg,"(1.0, 1.0, 1.0)",3100000
693,3,16300000,23800000,p24.3,gpos100,"(0.0, 0.0, 0.0)",7500000
694,3,23800000,26300000,p24.2,gneg,"(1.0, 1.0, 1.0)",2500000
695,3,26300000,30800000,p24.1,gpos75,"(0.2, 0.2, 0.2)",4500000
696,3,30800000,32000000,p23,gneg,"(1.0, 1.0, 1.0)",1200000
697,3,32000000,36400000,p22.3,gpos50,"(0.4, 0.4, 0.4)",4400000
698,3,36400000,39300000,p22.2,gneg,"(1.0, 1.0, 1.0)",2900000
699,3,39300000,43600000,p22.1,gpos75,"(0.2, 0.2, 0.2)",4300000
700,3,43600000,44100000,p21.33,gneg,"(1.0, 1.0, 1.0)",500000
701,3,44100000,44200000,p21.32,gpos50,"(0.4, 0.4, 0.4)",100000
702,3,44200000,50600000,p21.31,gneg,"(1.0, 1.0, 1.0)",6400000
703,3,50600000,52300000,p21.2,gpos25,"(0.6, 0.6, 0.6)",1700000
704,3,52300000,54400000,p21.1,gneg,"(1.0, 1.0, 1.0)",2100000
705,3,54400000,58600000,p14.3,gpos50,"(0.4, 0.4, 0.4)",4200000
706,3,58600000,63800000,p14.2,gneg,"(1.0, 1.0, 1.0)",5200000
707,3,63800000,69700000,p14.1,gpos50,"(0.4, 0.4, 0.4)",5900000
708,3,69700000,74100000,p13,gneg,"(1.0, 1.0, 1.0)",4400000
709,3,74100000,79800000,p12.3,gpos75,"(0.2, 0.2, 0.2)",5700000
710,3,79800000,83500000,p12.2,gneg,"(1.0, 1.0, 1.0)",3700000
711,3,83500000,87100000,p12.1,gpos75,"(0.2, 0.2, 0.2)",3600000
712,3,87100000,87800000,p11.2,gneg,"(1.0, 1.0, 1.0)",700000
713,3,87800000,90900000,p11.1,acen,red,3100000
714,3,90900000,94000000,q11.1,acen,red,3100000
715,3,94000000,98600000,q11.2,gvar,"(0.8, 0.8, 0.8)",4600000
716,3,98600000,100300000,q12.1,gneg,"(1.0, 1.0, 1.0)",1700000
717,3,100300000,101200000,q12.2,gpos25,"(0.6, 0.6, 0.6)",900000
718,3,101200000,103100000,q12.3,gneg,"(1.0, 1.0, 1.0)",1900000
719,3,103100000,106500000,q13.11,gpos75,"(0.2, 0.2, 0.2)",3400000
720,3,106500000,108200000,q13.12,gneg,"(1.0, 1.0, 1.0)",1700000
721,3,108200000,111600000,q13.13,gpos50,"(0.4, 0.4, 0.4)",3400000
722,3,111600000,113700000,q13.2,gneg,"(1.0, 1.0, 1.0)",2100000
723,3,113700000,117600000,q13.31,gpos75,"(0.2, 0.2, 0.2)",3900000
724,3,117600000,119300000,q13.32,gneg,"(1.0, 1.0, 1.0)",1700000
725,3,119300000,122200000,q13.33,gpos75,"(0.2, 0.2, 0.2)",2900000
726,3,122200000,124100000,q21.1,gneg,"(1.0, 1.0, 1.0)",1900000
727,3,124100000,126100000,q21.2,gpos25,"(0.6, 0.6, 0.6)",2000000
728,3,126100000,129500000,q21.3,gneg,"(1.0, 1.0, 1.0)",3400000
729,3,129500000,134000000,q22.1,gpos25,"(0.6, 0.6, 0.6)",4500000
730,3,134000000,136000000,q22.2,gneg,"(1.0, 1.0, 1.0)",2000000
731,3,136000000,139000000,q22.3,gpos25,"(0.6, 0.6, 0.6)",3000000
732,3,139000000,143100000,q23,gneg,"(1.0, 1.0, 1.0)",4100000
733,3,143100000,149200000,q24,gpos100,"(0.0, 0.0, 0.0)",6100000
734,3,149200000,152300000,q25.1,gneg,"(1.0, 1.0, 1.0)",3100000
735,3,152300000,155300000,q25.2,gpos50,"(0.4, 0.4, 0.4)",3000000
736,3,155300000,157300000,q25.31,gneg,"(1.0, 1.0, 1.0)",2000000
737,3,157300000,159300000,q25.32,gpos50,"(0.4, 0.4, 0.4)",2000000
738,3,159300000,161000000,q25.33,gneg,"(1.0, 1.0, 1.0)",1700000
739,3,161000000,167900000,q26.1,gpos100,"(0.0, 0.0, 0.0)",6900000
740,3,167900000,171200000,q26.2,gneg,"(1.0, 1.0, 1.0)",3300000
741,3,171200000,176000000,q26.31,gpos75,"(0.2, 0.2, 0.2)",4800000
742,3,176000000,179300000,q26.32,gneg,"(1.0, 1.0, 1.0)",3300000
743,3,179300000,183000000,q26.33,gpos75,"(0.2, 0.2, 0.2)",3700000
744,3,183000000,184800000,q27.1,gneg,"(1.0, 1.0, 1.0)",1800000
745,3,184800000,186300000,q27.2,gpos25,"(0.6, 0.6, 0.6)",1500000
746,3,186300000,188200000,q27.3,gneg,"(1.0, 1.0, 1.0)",1900000
747,3,188200000,192600000,q28,gpos75,"(0.2, 0.2, 0.2)",4400000
748,3,192600000,198295559,q29,gneg,"(1.0, 1.0, 1.0)",5695559
766,4,0,4500000,p16.3,gneg,"(1.0, 1.0, 1.0)",4500000
767,4,4500000,6000000,p16.2,gpos25,"(0.6, 0.6, 0.6)",1500000
768,4,6000000,11300000,p16.1,gneg,"(1.0, 1.0, 1.0)",5300000
769,4,11300000,15000000,p15.33,gpos50,"(0.4, 0.4, 0.4)",3700000
770,4,15000000,17700000,p15.32,gneg,"(1.0, 1.0, 1.0)",2700000
771,4,17700000,21300000,p15.31,gpos75,"(0.2, 0.2, 0.2)",3600000
772,4,21300000,27700000,p15.2,gneg,"(1.0, 1.0, 1.0)",6400000
773,4,27700000,35800000,p15.1,gpos100,"(0.0, 0.0, 0.0)",8100000
774,4,35800000,41200000,p14,gneg,"(1.0, 1.0, 1.0)",5400000
775,4,41200000,44600000,p13,gpos50,"(0.4, 0.4, 0.4)",3400000
776,4,44600000,48200000,p12,gneg,"(1.0, 1.0, 1.0)",3600000
777,4,48200000,50000000,p11,acen,red,1800000
778,4,50000000,51800000,q11,acen,red,1800000
779,4,51800000,58500000,q12,gneg,"(1.0, 1.0, 1.0)",6700000
780,4,58500000,65500000,q13.1,gpos100,"(0.0, 0.0, 0.0)",7000000
781,4,65500000,69400000,q13.2,gneg,"(1.0, 1.0, 1.0)",3900000
782,4,69400000,75300000,q13.3,gpos75,"(0.2, 0.2, 0.2)",5900000
783,4,75300000,78000000,q21.1,gneg,"(1.0, 1.0, 1.0)",2700000
784,4,78000000,81500000,q21.21,gpos50,"(0.4, 0.4, 0.4)",3500000
785,4,81500000,83200000,q21.22,gneg,"(1.0, 1.0, 1.0)",1700000
786,4,83200000,86000000,q21.23,gpos25,"(0.6, 0.6, 0.6)",2800000
787,4,86000000,87100000,q21.3,gneg,"(1.0, 1.0, 1.0)",1100000
788,4,87100000,92800000,q22.1,gpos75,"(0.2, 0.2, 0.2)",5700000
789,4,92800000,94200000,q22.2,gneg,"(1.0, 1.0, 1.0)",1400000
790,4,94200000,97900000,q22.3,gpos75,"(0.2, 0.2, 0.2)",3700000
791,4,97900000,100100000,q23,gneg,"(1.0, 1.0, 1.0)",2200000
792,4,100100000,106700000,q24,gpos50,"(0.4, 0.4, 0.4)",6600000
793,4,106700000,113200000,q25,gneg,"(1.0, 1.0, 1.0)",6500000
794,4,113200000,119900000,q26,gpos75,"(0.2, 0.2, 0.2)",6700000
795,4,119900000,122800000,q27,gneg,"(1.0, 1.0, 1.0)",2900000
796,4,122800000,127900000,q28.1,gpos50,"(0.4, 0.4, 0.4)",5100000
797,4,127900000,130100000,q28.2,gneg,"(1.0, 1.0, 1.0)",2200000
798,4,130100000,138500000,q28.3,gpos100,"(0.0, 0.0, 0.0)",8400000
799,4,138500000,140600000,q31.1,gneg,"(1.0, 1.0, 1.0)",2100000
800,4,140600000,145900000,q31.21,gpos25,"(0.6, 0.6, 0.6)",5300000
801,4,145900000,147500000,q31.22,gneg,"(1.0, 1.0, 1.0)",1600000
802,4,147500000,150200000,q31.23,gpos25,"(0.6, 0.6, 0.6)",2700000
803,4,150200000,154600000,q31.3,gneg,"(1.0, 1.0, 1.0)",4400000
804,4,154600000,160800000,q32.1,gpos100,"(0.0, 0.0, 0.0)",6200000
805,4,160800000,163600000,q32.2,gneg,"(1.0, 1.0, 1.0)",2800000
806,4,163600000,169200000,q32.3,gpos100,"(0.0, 0.0, 0.0)",5600000
807,4,169200000,171000000,q33,gneg,"(1.0, 1.0, 1.0)",1800000
808,4,171000000,175400000,q34.1,gpos75,"(0.2, 0.2, 0.2)",4400000
809,4,175400000,176600000,q34.2,gneg,"(1.0, 1.0, 1.0)",1200000
810,4,176600000,182300000,q34.3,gpos100,"(0.0, 0.0, 0.0)",5700000
811,4,182300000,186200000,q35.1,gneg,"(1.0, 1.0, 1.0)",3900000
812,4,186200000,190214555,q35.2,gpos25,"(0.6, 0.6, 0.6)",4014555
825,5,0,4400000,p15.33,gneg,"(1.0, 1.0, 1.0)",4400000
826,5,4400000,6300000,p15.32,gpos25,"(0.6, 0.6, 0.6)",1900000
827,5,6300000,9900000,p15.31,gneg,"(1.0, 1.0, 1.0)",3600000
828,5,9900000,15000000,p15.2,gpos50,"(0.4, 0.4, 0.4)",5100000
829,5,15000000,18400000,p15.1,gneg,"(1.0, 1.0, 1.0)",3400000
830,5,18400000,23300000,p14.3,gpos100,"(0.0, 0.0, 0.0)",4900000
831,5,23300000,24600000,p14.2,gneg,"(1.0, 1.0, 1.0)",1300000
832,5,24600000,28900000,p14.1,gpos100,"(0.0, 0.0, 0.0)",4300000
833,5,28900000,33800000,p13.3,gneg,"(1.0, 1.0, 1.0)",4900000
834,5,33800000,38400000,p13.2,gpos25,"(0.6, 0.6, 0.6)",4600000
835,5,38400000,42500000,p13.1,gneg,"(1.0, 1.0, 1.0)",4100000
836,5,42500000,46100000,p12,gpos50,"(0.4, 0.4, 0.4)",3600000
837,5,46100000,48800000,p11,acen,red,2700000
838,5,48800000,51400000,q11.1,acen,red,2600000
839,5,51400000,59600000,q11.2,gneg,"(1.0, 1.0, 1.0)",8200000
840,5,59600000,63600000,q12.1,gpos75,"(0.2, 0.2, 0.2)",4000000
841,5,63600000,63900000,q12.2,gneg,"(1.0, 1.0, 1.0)",300000
842,5,63900000,67400000,q12.3,gpos75,"(0.2, 0.2, 0.2)",3500000
843,5,67400000,69100000,q13.1,gneg,"(1.0, 1.0, 1.0)",1700000
844,5,69100000,74000000,q13.2,gpos50,"(0.4, 0.4, 0.4)",4900000
845,5,74000000,77600000,q13.3,gneg,"(1.0, 1.0, 1.0)",3600000
846,5,77600000,82100000,q14.1,gpos50,"(0.4, 0.4, 0.4)",4500000
847,5,82100000,83500000,q14.2,gneg,"(1.0, 1.0, 1.0)",1400000
848,5,83500000,93000000,q14.3,gpos100,"(0.0, 0.0, 0.0)",9500000
849,5,93000000,98900000,q15,gneg,"(1.0, 1.0, 1.0)",5900000
850,5,98900000,103400000,q21.1,gpos100,"(0.0, 0.0, 0.0)",4500000
851,5,103400000,105100000,q21.2,gneg,"(1.0, 1.0, 1.0)",1700000
852,5,105100000,110200000,q21.3,gpos100,"(0.0, 0.0, 0.0)",5100000
853,5,110200000,112200000,q22.1,gneg,"(1.0, 1.0, 1.0)",2000000
854,5,112200000,113800000,q22.2,gpos50,"(0.4, 0.4, 0.4)",1600000
855,5,113800000,115900000,q22.3,gneg,"(1.0, 1.0, 1.0)",2100000
856,5,115900000,122100000,q23.1,gpos100,"(0.0, 0.0, 0.0)",6200000
857,5,122100000,127900000,q23.2,gneg,"(1.0, 1.0, 1.0)",5800000
858,5,127900000,131200000,q23.3,gpos100,"(0.0, 0.0, 0.0)",3300000
859,5,131200000,136900000,q31.1,gneg,"(1.0, 1.0, 1.0)",5700000
860,5,136900000,140100000,q31.2,gpos25,"(0.6, 0.6, 0.6)",3200000
861,5,140100000,145100000,q31.3,gneg,"(1.0, 1.0, 1.0)",5000000
862,5,145100000,150400000,q32,gpos75,"(0.2, 0.2, 0.2)",5300000
863,5,150400000,153300000,q33.1,gneg,"(1.0, 1.0, 1.0)",2900000
864,5,153300000,156300000,q33.2,gpos50,"(0.4, 0.4, 0.4)",3000000
865,5,156300000,160500000,q33.3,gneg,"(1.0, 1.0, 1.0)",4200000
866,5,160500000,169000000,q34,gpos100,"(0.0, 0.0, 0.0)",8500000
867,5,169000000,173300000,q35.1,gneg,"(1.0, 1.0, 1.0)",4300000
868,5,173300000,177100000,q35.2,gpos25,"(0.6, 0.6, 0.6)",3800000
869,5,177100000,181538259,q35.3,gneg,"(1.0, 1.0, 1.0)",4438259
884,6,0,2300000,p25.3,gneg,"(1.0, 1.0, 1.0)",2300000
885,6,2300000,4200000,p25.2,gpos25,"(0.6, 0.6, 0.6)",1900000
886,6,4200000,7100000,p25.1,gneg,"(1.0, 1.0, 1.0)",2900000
887,6,7100000,10600000,p24.3,gpos50,"(0.4, 0.4, 0.4)",3500000
888,6,10600000,11600000,p24.2,gneg,"(1.0, 1.0, 1.0)",1000000
889,6,11600000,13400000,p24.1,gpos25,"(0.6, 0.6, 0.6)",1800000
890,6,13400000,15200000,p23,gneg,"(1.0, 1.0, 1.0)",1800000
891,6,15200000,25200000,p22.3,gpos75,"(0.2, 0.2, 0.2)",10000000
892,6,25200000,27100000,p22.2,gneg,"(1.0, 1.0, 1.0)",1900000
893,6,27100000,30500000,p22.1,gpos50,"(0.4, 0.4, 0.4)",3400000
894,6,30500000,32100000,p21.33,gneg,"(1.0, 1.0, 1.0)",1600000
895,6,32100000,33500000,p21.32,gpos25,"(0.6, 0.6, 0.6)",1400000
896,6,33500000,36600000,p21.31,gneg,"(1.0, 1.0, 1.0)",3100000
897,6,36600000,40500000,p21.2,gpos25,"(0.6, 0.6, 0.6)",3900000
898,6,40500000,46200000,p21.1,gneg,"(1.0, 1.0, 1.0)",5700000
899,6,46200000,51800000,p12.3,gpos100,"(0.0, 0.0, 0.0)",5600000
900,6,51800000,53000000,p12.2,gneg,"(1.0, 1.0, 1.0)",1200000
901,6,53000000,57200000,p12.1,gpos100,"(0.0, 0.0, 0.0)",4200000
902,6,57200000,58500000,p11.2,gneg,"(1.0, 1.0, 1.0)",1300000
903,6,58500000,59800000,p11.1,acen,red,1300000
904,6,59800000,62600000,q11.1,acen,red,2800000
905,6,62600000,62700000,q11.2,gneg,"(1.0, 1.0, 1.0)",100000
906,6,62700000,69200000,q12,gpos100,"(0.0, 0.0, 0.0)",6500000
907,6,69200000,75200000,q13,gneg,"(1.0, 1.0, 1.0)",6000000
908,6,75200000,83200000,q14.1,gpos50,"(0.4, 0.4, 0.4)",8000000
909,6,83200000,84200000,q14.2,gneg,"(1.0, 1.0, 1.0)",1000000
910,6,84200000,87300000,q14.3,gpos50,"(0.4, 0.4, 0.4)",3100000
911,6,87300000,92500000,q15,gneg,"(1.0, 1.0, 1.0)",5200000
912,6,92500000,98900000,q16.1,gpos100,"(0.0, 0.0, 0.0)",6400000
913,6,98900000,100000000,q16.2,gneg,"(1.0, 1.0, 1.0)",1100000
914,6,100000000,105000000,q16.3,gpos100,"(0.0, 0.0, 0.0)",5000000
915,6,105000000,114200000,q21,gneg,"(1.0, 1.0, 1.0)",9200000
916,6,114200000,117900000,q22.1,gpos75,"(0.2, 0.2, 0.2)",3700000
917,6,117900000,118100000,q22.2,gneg,"(1.0, 1.0, 1.0)",200000
918,6,118100000,125800000,q22.31,gpos100,"(0.0, 0.0, 0.0)",7700000
919,6,125800000,126800000,q22.32,gneg,"(1.0, 1.0, 1.0)",1000000
920,6,126800000,130000000,q22.33,gpos75,"(0.2, 0.2, 0.2)",3200000
921,6,130000000,130900000,q23.1,gneg,"(1.0, 1.0, 1.0)",900000
922,6,130900000,134700000,q23.2,gpos50,"(0.4, 0.4, 0.4)",3800000
923,6,134700000,138300000,q23.3,gneg,"(1.0, 1.0, 1.0)",3600000
924,6,138300000,142200000,q24.1,gpos75,"(0.2, 0.2, 0.2)",3900000
925,6,142200000,145100000,q24.2,gneg,"(1.0, 1.0, 1.0)",2900000
926,6,145100000,148500000,q24.3,gpos75,"(0.2, 0.2, 0.2)",3400000
927,6,148500000,152100000,q25.1,gneg,"(1.0, 1.0, 1.0)",3600000
928,6,152100000,155200000,q25.2,gpos50,"(0.4, 0.4, 0.4)",3100000
929,6,155200000,160600000,q25.3,gneg,"(1.0, 1.0, 1.0)",5400000
930,6,160600000,164100000,q26,gpos50,"(0.4, 0.4, 0.4)",3500000
931,6,164100000,170805979,q27,gneg,"(1.0, 1.0, 1.0)",6705979
948,7,0,2800000,p22.3,gneg,"(1.0, 1.0, 1.0)",2800000
949,7,2800000,4500000,p22.2,gpos25,"(0.6, 0.6, 0.6)",1700000
950,7,4500000,7200000,p22.1,gneg,"(1.0, 1.0, 1.0)",2700000
951,7,7200000,13700000,p21.3,gpos100,"(0.0, 0.0, 0.0)",6500000
952,7,13700000,16500000,p21.2,gneg,"(1.0, 1.0, 1.0)",2800000
953,7,16500000,20900000,p21.1,gpos100,"(0.0, 0.0, 0.0)",4400000
954,7,20900000,25500000,p15.3,gneg,"(1.0, 1.0, 1.0)",4600000
955,7,25500000,27900000,p15.2,gpos50,"(0.4, 0.4, 0.4)",2400000
956,7,27900000,28800000,p15.1,gneg,"(1.0, 1.0, 1.0)",900000
957,7,28800000,34900000,p14.3,gpos75,"(0.2, 0.2, 0.2)",6100000
958,7,34900000,37100000,p14.2,gneg,"(1.0, 1.0, 1.0)",2200000
959,7,37100000,43300000,p14.1,gpos75,"(0.2, 0.2, 0.2)",6200000
960,7,43300000,45400000,p13,gneg,"(1.0, 1.0, 1.0)",2100000
961,7,45400000,49000000,p12.3,gpos75,"(0.2, 0.2, 0.2)",3600000
962,7,49000000,50500000,p12.2,gneg,"(1.0, 1.0, 1.0)",1500000
963,7,50500000,53900000,p12.1,gpos75,"(0.2, 0.2, 0.2)",3400000
964,7,53900000,58100000,p11.2,gneg,"(1.0, 1.0, 1.0)",4200000
965,7,58100000,60100000,p11.1,acen,red,2000000
966,7,60100000,62100000,q11.1,acen,red,2000000
967,7,62100000,67500000,q11.21,gneg,"(1.0, 1.0, 1.0)",5400000
968,7,67500000,72700000,q11.22,gpos50,"(0.4, 0.4, 0.4)",5200000
969,7,72700000,77900000,q11.23,gneg,"(1.0, 1.0, 1.0)",5200000
970,7,77900000,86700000,q21.11,gpos100,"(0.0, 0.0, 0.0)",8800000
971,7,86700000,88500000,q21.12,gneg,"(1.0, 1.0, 1.0)",1800000
972,7,88500000,91500000,q21.13,gpos75,"(0.2, 0.2, 0.2)",3000000
973,7,91500000,93300000,q21.2,gneg,"(1.0, 1.0, 1.0)",1800000
974,7,93300000,98400000,q21.3,gpos75,"(0.2, 0.2, 0.2)",5100000
975,7,98400000,104200000,q22.1,gneg,"(1.0, 1.0, 1.0)",5800000
976,7,104200000,104900000,q22.2,gpos50,"(0.4, 0.4, 0.4)",700000
977,7,104900000,107800000,q22.3,gneg,"(1.0, 1.0, 1.0)",2900000
978,7,107800000,115000000,q31.1,gpos75,"(0.2, 0.2, 0.2)",7200000
979,7,115000000,117700000,q31.2,gneg,"(1.0, 1.0, 1.0)",2700000
980,7,117700000,121400000,q31.31,gpos75,"(0.2, 0.2, 0.2)",3700000
981,7,121400000,124100000,q31.32,gneg,"(1.0, 1.0, 1.0)",2700000
982,7,124100000,127500000,q31.33,gpos75,"(0.2, 0.2, 0.2)",3400000
983,7,127500000,129600000,q32.1,gneg,"(1.0, 1.0, 1.0)",2100000
984,7,129600000,130800000,q32.2,gpos25,"(0.6, 0.6, 0.6)",1200000
985,7,130800000,132900000,q32.3,gneg,"(1.0, 1.0, 1.0)",2100000
986,7,132900000,138500000,q33,gpos50,"(0.4, 0.4, 0.4)",5600000
987,7,138500000,143400000,q34,gneg,"(1.0, 1.0, 1.0)",4900000
988,7,143400000,148200000,q35,gpos75,"(0.2, 0.2, 0.2)",4800000
989,7,148200000,152800000,q36.1,gneg,"(1.0, 1.0, 1.0)",4600000
990,7,152800000,155200000,q36.2,gpos25,"(0.6, 0.6, 0.6)",2400000
991,7,155200000,159345973,q36.3,gneg,"(1.0, 1.0, 1.0)",4145973
1001,8,0,2300000,p23.3,gneg,"(1.0, 1.0, 1.0)",2300000
1002,8,2300000,6300000,p23.2,gpos75,"(0.2, 0.2, 0.2)",4000000
1003,8,6300000,12800000,p23.1,gneg,"(1.0, 1.0, 1.0)",6500000
1004,8,12800000,19200000,p22,gpos100,"(0.0, 0.0, 0.0)",6400000
1005,8,19200000,23500000,p21.3,gneg,"(1.0, 1.0, 1.0)",4300000
1006,8,23500000,27500000,p21.2,gpos50,"(0.4, 0.4, 0.4)",4000000
1007,8,27500000,29000000,p21.1,gneg,"(1.0, 1.0, 1.0)",1500000
1008,8,29000000,36700000,p12,gpos75,"(0.2, 0.2, 0.2)",7700000
1009,8,36700000,38500000,p11.23,gneg,"(1.0, 1.0, 1.0)",1800000
1010,8,38500000,39900000,p11.22,gpos25,"(0.6, 0.6, 0.6)",1400000
1011,8,39900000,43200000,p11.21,gneg,"(1.0, 1.0, 1.0)",3300000
1012,8,43200000,45200000,p11.1,acen,red,2000000
1013,8,45200000,47200000,q11.1,acen,red,2000000
1014,8,47200000,51300000,q11.21,gneg,"(1.0, 1.0, 1.0)",4100000
1015,8,51300000,51700000,q11.22,gpos75,"(0.2, 0.2, 0.2)",400000
1016,8,51700000,54600000,q11.23,gneg,"(1.0, 1.0, 1.0)",2900000
1017,8,54600000,60600000,q12.1,gpos50,"(0.4, 0.4, 0.4)",6000000
1018,8,60600000,61300000,q12.2,gneg,"(1.0, 1.0, 1.0)",700000
1019,8,61300000,65100000,q12.3,gpos50,"(0.4, 0.4, 0.4)",3800000
1020,8,65100000,67100000,q13.1,gneg,"(1.0, 1.0, 1.0)",2000000
1021,8,67100000,69600000,q13.2,gpos50,"(0.4, 0.4, 0.4)",2500000
1022,8,69600000,72000000,q13.3,gneg,"(1.0, 1.0, 1.0)",2400000
1023,8,72000000,74600000,q21.11,gpos100,"(0.0, 0.0, 0.0)",2600000
1024,8,74600000,74700000,q21.12,gneg,"(1.0, 1.0, 1.0)",100000
1025,8,74700000,83500000,q21.13,gpos75,"(0.2, 0.2, 0.2)",8800000
1026,8,83500000,85900000,q21.2,gneg,"(1.0, 1.0, 1.0)",2400000
1027,8,85900000,92300000,q21.3,gpos100,"(0.0, 0.0, 0.0)",6400000
1028,8,92300000,97900000,q22.1,gneg,"(1.0, 1.0, 1.0)",5600000
1029,8,97900000,100500000,q22.2,gpos25,"(0.6, 0.6, 0.6)",2600000
1030,8,100500000,105100000,q22.3,gneg,"(1.0, 1.0, 1.0)",4600000
1031,8,105100000,109500000,q23.1,gpos75,"(0.2, 0.2, 0.2)",4400000
1032,8,109500000,111100000,q23.2,gneg,"(1.0, 1.0, 1.0)",1600000
1033,8,111100000,116700000,q23.3,gpos100,"(0.0, 0.0, 0.0)",5600000
1034,8,116700000,118300000,q24.11,gneg,"(1.0, 1.0, 1.0)",1600000
1035,8,118300000,121500000,q24.12,gpos50,"(0.4, 0.4, 0.4)",3200000
1036,8,121500000,126300000,q24.13,gneg,"(1.0, 1.0, 1.0)",4800000
1037,8,126300000,130400000,q24.21,gpos50,"(0.4, 0.4, 0.4)",4100000
1038,8,130400000,135400000,q24.22,gneg,"(1.0, 1.0, 1.0)",5000000
1039,8,135400000,138900000,q24.23,gpos75,"(0.2, 0.2, 0.2)",3500000
1040,8,138900000,145138636,q24.3,gneg,"(1.0, 1.0, 1.0)",6238636
1057,9,0,2200000,p24.3,gneg,"(1.0, 1.0, 1.0)",2200000
1058,9,2200000,4600000,p24.2,gpos25,"(0.6, 0.6, 0.6)",2400000
1059,9,4600000,9000000,p24.1,gneg,"(1.0, 1.0, 1.0)",4400000
1060,9,9000000,14200000,p23,gpos75,"(0.2, 0.2, 0.2)",5200000
1061,9,14200000,16600000,p22.3,gneg,"(1.0, 1.0, 1.0)",2400000
1062,9,16600000,18500000,p22.2,gpos25,"(0.6, 0.6, 0.6)",1900000
1063,9,18500000,19900000,p22.1,gneg,"(1.0, 1.0, 1.0)",1400000
1064,9,19900000,25600000,p21.3,gpos100,"(0.0, 0.0, 0.0)",5700000
1065,9,25600000,28000000,p21.2,gneg,"(1.0, 1.0, 1.0)",2400000
1066,9,28000000,33200000,p21.1,gpos100,"(0.0, 0.0, 0.0)",5200000
1067,9,33200000,36300000,p13.3,gneg,"(1.0, 1.0, 1.0)",3100000
1068,9,36300000,37900000,p13.2,gpos25,"(0.6, 0.6, 0.6)",1600000
1069,9,37900000,39000000,p13.1,gneg,"(1.0, 1.0, 1.0)",1100000
1070,9,39000000,40000000,p12,gpos50,"(0.4, 0.4, 0.4)",1000000
1071,9,40000000,42200000,p11.2,gneg,"(1.0, 1.0, 1.0)",2200000
1072,9,42200000,43000000,p11.1,acen,red,800000
1073,9,43000000,45500000,q11,acen,red,2500000
1074,9,45500000,61500000,q12,gvar,"(0.8, 0.8, 0.8)",16000000
1075,9,61500000,65000000,q13,gneg,"(1.0, 1.0, 1.0)",3500000
1076,9,65000000,69300000,q21.11,gpos25,"(0.6, 0.6, 0.6)",4300000
1077,9,69300000,71300000,q21.12,gneg,"(1.0, 1.0, 1.0)",2000000
1078,9,71300000,76600000,q21.13,gpos50,"(0.4, 0.4, 0.4)",5300000
1079,9,76600000,78500000,q21.2,gneg,"(1.0, 1.0, 1.0)",1900000
1080,9,78500000,81500000,q21.31,gpos50,"(0.4, 0.4, 0.4)",3000000
1081,9,81500000,84300000,q21.32,gneg,"(1.0, 1.0, 1.0)",2800000
1082,9,84300000,87800000,q21.33,gpos50,"(0.4, 0.4, 0.4)",3500000
1083,9,87800000,89200000,q22.1,gneg,"(1.0, 1.0, 1.0)",1400000
1084,9,89200000,91200000,q22.2,gpos25,"(0.6, 0.6, 0.6)",2000000
1085,9,91200000,93900000,q22.31,gneg,"(1.0, 1.0, 1.0)",2700000
1086,9,93900000,96500000,q22.32,gpos25,"(0.6, 0.6, 0.6)",2600000
1087,9,96500000,99800000,q22.33,gneg,"(1.0, 1.0, 1.0)",3300000
1088,9,99800000,105400000,q31.1,gpos100,"(0.0, 0.0, 0.0)",5600000
1089,9,105400000,108500000,q31.2,gneg,"(1.0, 1.0, 1.0)",3100000
1090,9,108500000,112100000,q31.3,gpos25,"(0.6, 0.6, 0.6)",3600000
1091,9,112100000,114900000,q32,gneg,"(1.0, 1.0, 1.0)",2800000
1092,9,114900000,119800000,q33.1,gpos75,"(0.2, 0.2, 0.2)",4900000
1093,9,119800000,123100000,q33.2,gneg,"(1.0, 1.0, 1.0)",3300000
1094,9,123100000,127500000,q33.3,gpos25,"(0.6, 0.6, 0.6)",4400000
1095,9,127500000,130600000,q34.11,gneg,"(1.0, 1.0, 1.0)",3100000
1096,9,130600000,131100000,q34.12,gpos25,"(0.6, 0.6, 0.6)",500000
1097,9,131100000,133100000,q34.13,gneg,"(1.0, 1.0, 1.0)",2000000
1098,9,133100000,134500000,q34.2,gpos25,"(0.6, 0.6, 0.6)",1400000
1099,9,134500000,138394717,q34.3,gneg,"(1.0, 1.0, 1.0)",3894717
1237,23,0,4400000,p22.33,gneg,"(1.0, 1.0, 1.0)",4400000
1238,23,4400000,6100000,p22.32,gpos50,"(0.4, 0.4, 0.4)",1700000
1239,23,6100000,9600000,p22.31,gneg,"(1.0, 1.0, 1.0)",3500000
1240,23,9600000,17400000,p22.2,gpos50,"(0.4, 0.4, 0.4)",7800000
1241,23,17400000,19200000,p22.13,gneg,"(1.0, 1.0, 1.0)",1800000
1242,23,19200000,21900000,p22.12,gpos50,"(0.4, 0.4, 0.4)",2700000
1243,23,21900000,24900000,p22.11,gneg,"(1.0, 1.0, 1.0)",3000000
1244,23,24900000,29300000,p21.3,gpos100,"(0.0, 0.0, 0.0)",4400000
1245,23,29300000,31500000,p21.2,gneg,"(1.0, 1.0, 1.0)",2200000
1246,23,31500000,37800000,p21.1,gpos100,"(0.0, 0.0, 0.0)",6300000
1247,23,37800000,42500000,p11.4,gneg,"(1.0, 1.0, 1.0)",4700000
1248,23,42500000,47600000,p11.3,gpos75,"(0.2, 0.2, 0.2)",5100000
1249,23,47600000,50100000,p11.23,gneg,"(1.0, 1.0, 1.0)",2500000
1250,23,50100000,54800000,p11.22,gpos25,"(0.6, 0.6, 0.6)",4700000
1251,23,54800000,58100000,p11.21,gneg,"(1.0, 1.0, 1.0)",3300000
1252,23,58100000,61000000,p11.1,acen,red,2900000
1253,23,61000000,63800000,q11.1,acen,red,2800000
1254,23,63800000,65400000,q11.2,gneg,"(1.0, 1.0, 1.0)",1600000
1255,23,65400000,68500000,q12,gpos50,"(0.4, 0.4, 0.4)",3100000
1256,23,68500000,73000000,q13.1,gneg,"(1.0, 1.0, 1.0)",4500000
1257,23,73000000,74700000,q13.2,gpos50,"(0.4, 0.4, 0.4)",1700000
1258,23,74700000,76800000,q13.3,gneg,"(1.0, 1.0, 1.0)",2100000
1259,23,76800000,85400000,q21.1,gpos100,"(0.0, 0.0, 0.0)",8600000
1260,23,85400000,87000000,q21.2,gneg,"(1.0, 1.0, 1.0)",1600000
1261,23,87000000,92700000,q21.31,gpos100,"(0.0, 0.0, 0.0)",5700000
1262,23,92700000,94300000,q21.32,gneg,"(1.0, 1.0, 1.0)",1600000
1263,23,94300000,99100000,q21.33,gpos75,"(0.2, 0.2, 0.2)",4800000
1264,23,99100000,103300000,q22.1,gneg,"(1.0, 1.0, 1.0)",4200000
1265,23,103300000,104500000,q22.2,gpos50,"(0.4, 0.4, 0.4)",1200000
1266,23,104500000,109400000,q22.3,gneg,"(1.0, 1.0, 1.0)",4900000
1267,23,109400000,117400000,q23,gpos75,"(0.2, 0.2, 0.2)",8000000
1268,23,117400000,121800000,q24,gneg,"(1.0, 1.0, 1.0)",4400000
1269,23,121800000,129500000,q25,gpos100,"(0.0, 0.0, 0.0)",7700000
1270,23,129500000,131300000,q26.1,gneg,"(1.0, 1.0, 1.0)",1800000
1271,23,131300000,134500000,q26.2,gpos25,"(0.6, 0.6, 0.6)",3200000
1272,23,134500000,138900000,q26.3,gneg,"(1.0, 1.0, 1.0)",4400000
1273,23,138900000,141200000,q27.1,gpos75,"(0.2, 0.2, 0.2)",2300000
1274,23,141200000,143000000,q27.2,gneg,"(1.0, 1.0, 1.0)",1800000
1275,23,143000000,148000000,q27.3,gpos100,"(0.0, 0.0, 0.0)",5000000
1276,23,148000000,156040895,q28,gneg,"(1.0, 1.0, 1.0)",8040895
1280,24,0,300000,p11.32,gneg,"(1.0, 1.0, 1.0)",300000
1281,24,300000,600000,p11.31,gpos50,"(0.4, 0.4, 0.4)",300000
1282,24,600000,10300000,p11.2,gneg,"(1.0, 1.0, 1.0)",9700000
1283,24,10300000,10400000,p11.1,acen,red,100000
1284,24,10400000,10600000,q11.1,acen,red,200000
1285,24,10600000,12400000,q11.21,gneg,"(1.0, 1.0, 1.0)",1800000
1286,24,12400000,17100000,q11.221,gpos50,"(0.4, 0.4, 0.4)",4700000
1287,24,17100000,19600000,q11.222,gneg,"(1.0, 1.0, 1.0)",2500000
1288,24,19600000,23800000,q11.223,gpos50,"(0.4, 0.4, 0.4)",4200000
1289,24,23800000,26600000,q11.23,gneg,"(1.0, 1.0, 1.0)",2800000
1290,24,26600000,57227415,q12,gvar,"(0.8, 0.8, 0.8)",30627415
